+--------------------------------------------------------------------+
|                                                                    |
|                                                                    |
|                                                                    |
|                                                                    |
|                                                                    |
|--------------------------------------------------------------------|
|                                                                    |
|                                                                    |
|                                                                    |
|                                                                    |
|                                                                    |
|                                                                    |
|                                                                    |
|                                                                    |
|                                                                    |
|                                                                    |
|                                                                    |
|                                                                    |
+---------------------------+=====+----------------------------------+
