+--------------------------------------------------------------------+
|                                             |                      |
|                                             |                      |
|                                             |                      |
|                                             |                      |
|---------------------------------------------|----------------------|
|                                             |                      |
|                                             |                      |
|                                             |                      |
|                                             |                      |
|                                             |                      |
|-------------------------------+             +       +--------------|
|                               |                     |              |
|                               |                     |              |
|                               |                     |              |
|-------------------------------+                     +--------------|
|                                                                    |
|                                                                    |
|                                                                    |
+---------+=====+----------------------------------------------------+
