+------------------------------------------------+████████████████████
|                                                |████████████████████
|                                                |████████████████████
|                                                |████████████████████
|                                                |████████████████████
|                                                |████████████████████
|------------------------------------------------|████████████████████
|                                                |████████████████████
|                                                |████████████████████
|                                                |████████████████████
|                                                |████████████████████
|                                                |████████████████████
|                                                |████████████████████
|                                                |████████████████████
|                                                |████████████████████
|                                                |████████████████████
|                                                |████████████████████
|                                                |████████████████████
|                                                |████████████████████
+---------------+=====+--------------------------+████████████████████
