███████████████████████████+-----------------------------------------+
███████████████████████████|                                         |
███████████████████████████|                                         |
███████████████████████████|                                         |
███████████████████████████|                                         |
███████████████████████████|                                         |
███████████████████████████|                                         |
███████████████████████████|-----------------------------------------|
███████████████████████████|                                         |
███████████████████████████|                                         |
███████████████████████████|                                         |
███████████████████████████|                                         |
███████████████████████████|                                         |
███████████████████████████|                                         |
███████████████████████████|                                         |
███████████████████████████|                                         |
███████████████████████████|                                         |
███████████████████████████|                                         |
███████████████████████████|                                         |
███████████████████████████+---------+=====+-------------------------+
