|--.--.--.--.--.--.-.____//______//___,.--.--.--.--.--.--.--.--.--.--.--.--.--.--.--.--.--.--.|
| |  |  |  |  |  |  `-----------------'  |  |  |  |  |  |  |  |  |  |  |  |  |  |  |  |  |  | |
| |  |  |  |  |  |  |  |  |  |  |  |  |  |  |  |  |  |  |  |  |  |  |  |  |  |  |  |  |  |  | |
| |  |  |  |  |  |  |  |  |  |  |  |  |  |  |  |  |  |  |  |  |  |  |  |  |  |  |  |  |  |  | |
| |  |  |  |  |  |  |  |  |  |  |  |  |  |  |  |  |  |  |  |  |  |  |  |  |  |  |  |  |  |  | |
+=============================================================================================+
|                                                                                             |
|                                                                                             |
|                                                                                             |
|                                                                                             |
|                                                                                             |
|                                                                                             |
|                                                                                             |
|                                                                                             |
|                                                                                             |
|                                                                                             |
|                                                                                             |
|                                                                                             |
|                                                                                             |
|                                                                                             |
|                                                                                             |
|                                                                                             |
|                                                                                             |
|                                                                                             |
+---------------------------------------------------------------------------------------------+
