+--------------------------------------------------------------------+
|                                                                    |
|                                                                    |
|                                                                    |
|                                                                    |
|                                                                    |
|                                                                    |
|--------------------------------------------------------------------|
|                                                                    |
|                                                                    |
|                                                                    |
|                                                                    |
|                                                                    |
+---------+                                                +---------+
██████████|                                                |██████████
██████████|                                                |██████████
██████████|                                                |██████████
██████████|                                                |██████████
██████████|                                                |██████████
██████████+----------+=====+-------------------------------+██████████
