+--------------------------------------------------------------------+
|             |                |                 |                   |
|             |                |                 |                   |
|   +----+    |         +----+ |   +----+        |     +----+        |
|   |    |    |         |    | |   |    |        |     |    |        |
|   |.   |    |         |.   | |   |.   |        |     |.   |        |
|   |    |    |         |    | |   |    |        |     |    |        |
|--------------------------------------------------------------------|
|                                                                    |
|                                                                    |
|                                                                    |
|                                                                    |
|---+====+--------------+====+-----+             +-----+====+--------|
|             |                    |             |                   |
|             |                    |             |                   |
|             |                    |             |                   |
|             |                    |             |                   |
|             |                    |             |                   |
|             |                    |             |                   |
+--------------------------------------------------------------------+
